000011111111100001111111111
000000111001111000000111111
000000010000110000000000011
000000000000000000000000000
000000000000100000000000001
110011111001111000000001110
000000110001111100000000000
110000000101111100000000010
111000000001110000000000001
000000000000100000000000001
000000000000100000000000001
000000000000000000000000001
000000000000010000000000001
000000000000010000000000001
000000000000010000000000001
000000000000010000000000001
000000000000010000000000001
000000000000010000000000000
000000000000010000000000000
000000000000010000000000000
000000000000010000000000001
000000000000010000000000001
000000000000010000000000000
000000000000010000000000000
000000000000010000000000000
000000000000010000000000000
000000000000010000000000000
